"filename", "language", "C++", "CMake", "comment", "blank", "total"
"/home/aiden/Development/starry/starry/CMakeLists.txt", "CMake", 0, 10, 0, 3, 13
"/home/aiden/Development/starry/starry/base/CMakeLists.txt", "CMake", 0, 12, 0, 2, 14
"/home/aiden/Development/starry/starry/base/copyable/CMakeLists.txt", "CMake", 0, 3, 0, 2, 5
"/home/aiden/Development/starry/starry/base/copyable/include/copyable.h", "C++", 3, 0, 0, 3, 6
"/home/aiden/Development/starry/starry/base/log/CMakeLists.txt", "CMake", 0, 15, 0, 5, 20
"/home/aiden/Development/starry/starry/base/log/include/async_logging.h", "C++", 39, 0, 1, 10, 50
"/home/aiden/Development/starry/starry/base/log/include/log_file.h", "C++", 36, 0, 1, 10, 47
"/home/aiden/Development/starry/starry/base/log/include/log_stream.h", "C++", 62, 0, 5, 14, 81
"/home/aiden/Development/starry/starry/base/log/include/logging.h", "C++", 42, 0, 4, 16, 62
"/home/aiden/Development/starry/starry/base/log/src/async_logger.cpp", "C++", 96, 0, 4, 18, 118
"/home/aiden/Development/starry/starry/base/log/src/log_file.cpp", "C++", 85, 0, 6, 10, 101
"/home/aiden/Development/starry/starry/base/log/src/logging.cpp", "C++", 71, 0, 4, 17, 92
"/home/aiden/Development/starry/starry/base/log/test/CMakeLists.txt", "CMake", 0, 19, 0, 6, 25
"/home/aiden/Development/starry/starry/base/log/test/log_performance_test.cpp", "C++", 115, 0, 11, 34, 160
"/home/aiden/Development/starry/starry/base/log/test/logger_test.cpp", "C++", 70, 0, 9, 21, 100
"/home/aiden/Development/starry/starry/base/noncopyable/CMakeLists.txt", "CMake", 0, 4, 0, 2, 6
"/home/aiden/Development/starry/starry/base/noncopyable/include/noncopyable.h", "C++", 11, 0, 0, 3, 14
"/home/aiden/Development/starry/starry/base/thread_pool/CMakeLists.txt", "CMake", 0, 7, 0, 3, 10
"/home/aiden/Development/starry/starry/base/thread_pool/include/thread_pool.h", "C++", 106, 0, 0, 19, 125
"/home/aiden/Development/starry/starry/base/thread_pool/test/CMakeLists.txt", "CMake", 0, 8, 0, 4, 12
"/home/aiden/Development/starry/starry/base/thread_pool/test/thread_pool_test.cpp", "C++", 48, 0, 1, 16, 65
"/home/aiden/Development/starry/starry/net/CMakeLists.txt", "CMake", 0, 29, 0, 5, 34
"/home/aiden/Development/starry/starry/net/include/acceptor.h", "C++", 30, 0, 1, 10, 41
"/home/aiden/Development/starry/starry/net/include/buffer.h", "C++", 210, 0, 31, 30, 271
"/home/aiden/Development/starry/starry/net/include/callbacks.h", "C++", 23, 0, 0, 5, 28
"/home/aiden/Development/starry/starry/net/include/channel.h", "C++", 58, 0, 6, 17, 81
"/home/aiden/Development/starry/starry/net/include/connector.h", "C++", 49, 0, 1, 14, 64
"/home/aiden/Development/starry/starry/net/include/epoll_poller.h", "C++", 25, 0, 3, 11, 39
"/home/aiden/Development/starry/starry/net/include/eventloop.h", "C++", 68, 0, 13, 22, 103
"/home/aiden/Development/starry/starry/net/include/eventloop_thread.h", "C++", 27, 0, 1, 10, 38
"/home/aiden/Development/starry/starry/net/include/eventloop_threadpool.h", "C++", 30, 0, 2, 11, 43
"/home/aiden/Development/starry/starry/net/include/inet_address.h", "C++", 35, 0, 8, 11, 54
"/home/aiden/Development/starry/starry/net/include/poller.h", "C++", 28, 0, 2, 11, 41
"/home/aiden/Development/starry/starry/net/include/socket.h", "C++", 25, 0, 0, 10, 35
"/home/aiden/Development/starry/starry/net/include/sockets_ops.h", "C++", 33, 0, 3, 10, 46
"/home/aiden/Development/starry/starry/net/include/tcp_client.h", "C++", 48, 0, 0, 15, 63
"/home/aiden/Development/starry/starry/net/include/tcp_connection.h", "C++", 93, 0, 9, 17, 119
"/home/aiden/Development/starry/starry/net/include/tcp_server.h", "C++", 61, 0, 0, 15, 76
"/home/aiden/Development/starry/starry/net/include/timer.h", "C++", 31, 0, 0, 9, 40
"/home/aiden/Development/starry/starry/net/include/timer_id.h", "C++", 14, 0, 0, 7, 21
"/home/aiden/Development/starry/starry/net/include/timer_queue.h", "C++", 37, 0, 0, 12, 49
"/home/aiden/Development/starry/starry/net/src/acceptor.cpp", "C++", 56, 0, 2, 7, 65
"/home/aiden/Development/starry/starry/net/src/buffer.cpp", "C++", 30, 0, 1, 7, 38
"/home/aiden/Development/starry/starry/net/src/channel.cpp", "C++", 93, 0, 0, 18, 111
"/home/aiden/Development/starry/starry/net/src/connector.cpp", "C++", 165, 0, 13, 23, 201
"/home/aiden/Development/starry/starry/net/src/epoll_poller.cpp", "C++", 140, 0, 6, 16, 162
"/home/aiden/Development/starry/starry/net/src/eventloop.cpp", "C++", 186, 0, 16, 29, 231
"/home/aiden/Development/starry/starry/net/src/eventloop_thread.cpp", "C++", 39, 0, 2, 13, 54
"/home/aiden/Development/starry/starry/net/src/eventloop_threadpool.cpp", "C++", 56, 0, 4, 13, 73
"/home/aiden/Development/starry/starry/net/src/inet_address.cpp", "C++", 77, 0, 8, 13, 98
"/home/aiden/Development/starry/starry/net/src/poller.cpp", "C++", 15, 0, 0, 5, 20
"/home/aiden/Development/starry/starry/net/src/socket.cpp", "C++", 80, 0, 0, 14, 94
"/home/aiden/Development/starry/starry/net/src/sockets_ops.cpp", "C++", 200, 0, 19, 26, 245
"/home/aiden/Development/starry/starry/net/src/tcp_client.cpp", "C++", 107, 0, 1, 15, 123
"/home/aiden/Development/starry/starry/net/src/tcp_connection.cpp", "C++", 271, 0, 26, 32, 329
"/home/aiden/Development/starry/starry/net/src/tcp_server.cpp", "C++", 85, 0, 5, 12, 102
"/home/aiden/Development/starry/starry/net/src/timer.cpp", "C++", 14, 0, 0, 4, 18
"/home/aiden/Development/starry/starry/net/src/timer_queue.cpp", "C++", 173, 0, 0, 30, 203
"/home/aiden/Development/starry/starry/net/test/CMakeLists.txt", "CMake", 0, 28, 0, 4, 32
"/home/aiden/Development/starry/starry/net/test/buffer_test.cpp", "C++", 63, 0, 18, 20, 101
"/home/aiden/Development/starry/starry/net/test/inet_address_test.cpp", "C++", 60, 0, 6, 15, 81
"/home/aiden/Development/starry/starry/net/test/socket_test.cpp", "C++", 65, 0, 26, 18, 109
"Total", "-", 3684, 135, 279, 804, 4902